BOTTLE	B AA T AH L
BOWL	B OW L
BOX	B AA K S
CAN	K AE N
CAN(2)	K AH N
CARTON	K AA R T AH N
CONTAINER	K AH N T EY N ER
CUP	K AH P
DRILL	D R IH L
FUNNEL	F AH N AH L
GLASS	G L AE S
JAR	JH AA R
JUG	JH AH G
MUG	M AH G
PITCHER	P IH CH ER
PLATE	P L EY T
SAUCER	S AO S ER
SPORTS	S P AO R T S
TOOL	T UW L
TOY	T OY
TUB	T AH B
TUMBLER	T AH M B L ER
WATER	W AO T ER
